....................
....................
....................
~~~~~~~-.-.--.......
~~~~~~~-.-.--.......
-------------------.
....................
....................
...........---------
....................