000000000000000
-------v------0
000000000000000
0------v-------
0000000000][000
-------v------0
00][00000000000
0------v-------
][0000000000000
000000000000000