....-..........
---.---.------.
........-......
-------v---.---
.....-vv-......
.---.--v------.
.|.............
.--------------
....--...--....
.--....-....--.