....-------------
--.....----------
--......---------
--.......--------
--........-------
--..........-----
--...........----
--............---
--.............--
--------------...