......--------------
-----.--------------
-----.......--------
-----.-----.-...----
-----.-----.....----
----.....-----------
----............----
----.....-----------
--------.-----------
--------............