0000-0000000000
---0---0------0
00000000-000000
-------v---0---
00000-vv-000000
0---0--v------0
0|0000000000000
0--------------
0000--000--0000
0--0000-0000--0