0000000~~0000~~0000000
00000~~00000000~~00000
000==0000###0000~~~000
0~~0000########00~~000
~~0000##########00~~~0
~000########v####00~~~
~0##################||
00##############||||||
00000###########||||||
0000##############||||
00##################||
00###################|
0000#################|
000000################