0000000~~0000~~0000000
00000~~00000000~~00000
000==0000###0000===000
0~~0000########00~~000
~~0000##########00~~~0
~000#############00~~~
~0#################v||
00v#############||||||
00000v##########||||||
0000##############||||
00v################v||
00###################|
0000#################|
000000################