..--..--.....--..--..
..--.............--..
..--------.--------..
..--------.--------..
..--------.--------..
..--------.--------..
.....................
----.............----
--.................--
----.............----
.....................