000000000000000
--------------0
000000000000000
0--------------
0000~~=~~000000
--------------0
000000000000000
0--------------
000000000000000
000000000000000