00000000000000000000
000000000000000][000
00000000000000000000
~~~~~~~-0-0--0000000
~~~~~~~-0-0--0000000
-------------------0
00][0000000000000000
00000000000000000000
00000000000---------
00000000000000000000