.......~~....~~.......
.....~~........~~.....
...==....___....===...
.~~....________..~~...
~~....__________..~~~.
~..._____________..~~~
~._________________v||
..v_____________||||||
.....v__________||||||
....______________||||
..v________________v||
..___________________|
...._________________|
......________________