000000000000000
-------v------0
000000000000000
0------v-------
000000000000000
-------v------0
000000000000000
0------v-------
000000000000000
000000000000000